Cell	cell_type
RS5F_AAACCCAGTCGCATGC	M-X-cells (GHRL)
RS5F_AAAGTCCCACTCCGAG	EC-cells (TPH1)
RS5F_AACAAAGCACCTGTCT	M-X-cells (GHRL)
RS5F_AACAACCCACAGTCGC	M-X-cells (GHRL)
RS5F_AACAACCGTGATGAAT	EC-cells (TPH1)
RS5F_AAGATAGCAGCGTTGC	EC-cells (TPH1)
RS5F_AATCGTGAGACCATTC	EC-cells (TPH1)
RS5F_AATCGTGGTAATACCC	ECL-cells (HDC,MAOB)
RS5F_AATCGTGTCCGTGGGT	EC-cells (TPH1)
RS5F_AATGACCGTCGTCATA	EC-cells (TPH1)
RS5F_AATGGCTTCTGGGCGT	EC-cells (TPH1)
RS5F_ACAACCATCCCATGGG	EC-cells (TPH1)
RS5F_ACAGCCGAGTCTTCGA	EC-cells (TPH1)
RS5F_ACCATTTTCGCACGAC	EC-cells (TPH1)
RS5F_ACCTGAACAGCTCTGG	EC-cells (TPH1)
RS5F_ACGGGTCAGTGAACAT	EC-cells (TPH1)
RS5F_ACGGTCGGTCTGTTAG	EC-cells (TPH1)
RS5F_ACTTAGGAGATAACGT	M-X-cells (GHRL)
RS5F_ACTTCCGGTTCGATTG	EC-cells (TPH1)
RS5F_ACTTCGCAGATGAATC	M-X-cells (GHRL)
RS5F_AGACAAATCATTGGTG	EC-cells (TPH1)
RS5F_AGACACTTCCAATCCC	EC-cells (TPH1)
RS5F_AGATAGACACGGCTAC	M-X-cells (GHRL)
RS5F_AGATAGAGTGGGCTTC	M-X-cells (GHRL)
RS5F_AGATGAATCTTTACAC	EC-cells (TPH1)
RS5F_AGCCAATGTCTACGTA	EC-cells (TPH1)
RS5F_AGCCAGCCAGCACAGA	EC-cells (TPH1)
RS5F_AGCCAGCCAGGCTTGC	EC-cells (TPH1)
RS5F_AGCGTATAGGTATCTC	EC-cells (TPH1)
RS5F_AGCGTCGAGCATGATA	ECL-cells (HDC,MAOB)
RS5F_AGCTCAATCGGCCCAA	ECL-cells (HDC,MAOB)
RS5F_AGGACTTTCACCATCC	M-X-cells (GHRL)
RS5F_AGGAGGTCAATCGCAT	EC-cells (TPH1)
RS5F_AGGCATTCACGCTGAC	ECL-cells (HDC,MAOB)
RS5F_AGGCATTGTCTACTGA	EC-cells (TPH1)
RS5F_AGGCCACTCGTTCCCA	M-X-cells (GHRL)
RS5F_AGGGTTTAGACCTGGA	ECL-cells (HDC,MAOB)
RS5F_AGGTTGTGTCCAACGC	EC-cells (TPH1)
RS5F_AGTAGCTGTACCACGC	EC-cells (TPH1)
RS5F_AGTAGCTGTATCACCA	M-X-cells (GHRL)
RS5F_AGTGCCGGTATCCCAA	M-X-cells (GHRL)
RS5F_ATAGGCTAGCCTCACG	EC-cells (TPH1)
RS5F_ATCGTGATCTACGGTA	EC-cells (TPH1)
RS5F_ATGCCTCTCGGCTCTT	EC-cells (TPH1)
RS5F_ATGGGTTAGATCACCT	ECL-cells (HDC,MAOB)
RS5F_ATGGTTGTCTCACTCG	EC-cells (TPH1)
RS5F_ATGTCCCGTCGTCATA	EC-cells (TPH1)
RS5F_ATTATCCTCATGCATG	EC-cells (TPH1)
RS5F_ATTCACTTCATGTCAG	EC-cells (TPH1)
RS5F_ATTCCATCACTACTTT	EC-cells (TPH1)
RS5F_ATTGTTCAGGCCTGCT	EC-cells (TPH1)
RS5F_ATTTACCGTTAAGAAC	M-X-cells (GHRL)
RS5F_ATTTCTGGTGATTGGG	M-X-cells (GHRL)
RS5F_CAACCAATCGCAATTG	EC-cells (TPH1)
RS5F_CAACCTCCATGGAGAC	EC-cells (TPH1)
RS5F_CAACGATAGTTGCCCG	EC-cells (TPH1)
RS5F_CAACGGCGTTCCGTTC	EC-cells (TPH1)
RS5F_CAATTTCCACCCTATC	M-X-cells (GHRL)
RS5F_CACACAAGTGTGGACA	M-X-cells (GHRL)
RS5F_CACATGAGTGAGCAGT	M-X-cells (GHRL)
RS5F_CACGGGTTCTTCGCTG	M-X-cells (GHRL)
RS5F_CACGTGGCAGGGTTGA	EC-cells (TPH1)
RS5F_CACTGAATCTGGGATT	M-X-cells (GHRL)
RS5F_CACTGTCCATCTCAAG	EC-cells (TPH1)
RS5F_CACTGTCGTAAGCAAT	M-X-cells (GHRL)
RS5F_CAGCACGTCGAGTCTA	M-X-cells (GHRL)
RS5F_CAGCAGCGTGGAATGC	EC-cells (TPH1)
RS5F_CAGCCAGAGGCATCTT	EC-cells (TPH1)
RS5F_CAGCGTGGTACCAATC	EC-cells (TPH1)
RS5F_CAGGGCTCAGTGTGCC	EC-cells (TPH1)
RS5F_CAGTGCGAGTGATTCC	EC-cells (TPH1)
RS5F_CAGTTCCCAGTTAAAG	EC-cells (TPH1)
RS5F_CAGTTCCTCTTCCACG	EC-cells (TPH1)
RS5F_CATAAGCAGGGTACGT	EC-cells (TPH1)
RS5F_CATACAGTCTCGGTAA	M-X-cells (GHRL)
RS5F_CATGCTCAGCAAGTCG	EC-cells (TPH1)
RS5F_CATGCTCTCCTACGGG	EC-cells (TPH1)
RS5F_CATTCTAGTCAAACGG	EC-cells (TPH1)
RS5F_CATTGCCCAGCTGAGA	M-X-cells (GHRL)
RS5F_CCACAAATCTGTGCGG	EC-cells (TPH1)
RS5F_CCACGAGGTAGCGAGT	EC-cells (TPH1)
RS5F_CCACGTTGTAGACAGC	EC-cells (TPH1)
RS5F_CCATAAGAGTCTTGGT	ECL-cells (HDC,MAOB)
RS5F_CCATAAGCACGAGAAC	EC-cells (TPH1)
RS5F_CCATCACAGGAGGGTG	M-X-cells (GHRL)
RS5F_CCCGGAAGTGAGTCAG	EC-cells (TPH1)
RS5F_CCGAACGTCCACGTAA	EC-cells (TPH1)
RS5F_CCGTTCAGTTACCCTC	EC-cells (TPH1)
RS5F_CCTCCAACATGCCGAC	EC-cells (TPH1)
RS5F_CCTTCAGCAGGCTCTG	EC-cells (TPH1)
RS5F_CCTTCAGTCCCAGGCA	M-X-cells (GHRL)
RS5F_CCTTGTGGTATTTCGG	EC-cells (TPH1)
RS5F_CGAGGCTCAACAAGAT	EC-cells (TPH1)
RS5F_CGAGTGCTCTCCGATC	M-X-cells (GHRL)
RS5F_CGCAGGTGTATTGCCA	M-X-cells (GHRL)
RS5F_CGCCATTGTAGTCTTG	EC-cells (TPH1)
RS5F_CGGAACCTCAGGACAG	M-X-cells (GHRL)
RS5F_CGGGACTTCAAGCCGC	EC-cells (TPH1)
RS5F_CGGGACTTCTTACTGT	EC-cells (TPH1)
RS5F_CGGGCATGTAACCCTA	EC-cells (TPH1)
RS5F_CGGGTCACATCTGCGG	EC-cells (TPH1)
RS5F_CGGGTGTAGGCTCCCA	M-X-cells (GHRL)
RS5F_CGGTCAGAGACTGGGT	M-X-cells (GHRL)
RS5F_CGTGATAGTCACTGAT	EC-cells (TPH1)
RS5F_CTACCCATCTCGAGTA	EC-cells (TPH1)
RS5F_CTACCTGTCGCCGAGT	ECL-cells (HDC,MAOB)
RS5F_CTATCCGGTAGAGCTG	EC-cells (TPH1)
RS5F_CTCATCGGTAACGCGA	EC-cells (TPH1)
RS5F_CTCATGCTCAAGCCCG	EC-cells (TPH1)
RS5F_CTCCATGAGTAATCCC	M-X-cells (GHRL)
RS5F_CTCCATGTCTTGAACG	M-X-cells (GHRL)
RS5F_CTCCGATTCCTAGCGG	M-X-cells (GHRL)
RS5F_CTCTCAGGTCACGACC	EC-cells (TPH1)
RS5F_CTGAGGCTCCAAGCCG	ECL-cells (HDC,MAOB)
RS5F_CTGATCCAGCCGATAG	EC-cells (TPH1)
RS5F_CTGCATCAGGGCAACT	EC-cells (TPH1)
RS5F_CTGCGAGCATGCTGCG	EC-cells (TPH1)
RS5F_CTGCTCACAAGGTACG	EC-cells (TPH1)
RS5F_GAAATGACACGACAAG	EC-cells (TPH1)
RS5F_GAAATGAGTAGCCAGA	M-X-cells (GHRL)
RS5F_GAACTGTGTTTGGCTA	EC-cells (TPH1)
RS5F_GAAGCGAGTGCAGATG	EC-cells (TPH1)
RS5F_GAAGCGAGTTAGGGAC	EC-cells (TPH1)
RS5F_GAAGTAACACCAGCCA	EC-cells (TPH1)
RS5F_GACCCAGAGGCCTTCG	EC-cells (TPH1)
RS5F_GACCCTTAGGATATGT	M-X-cells (GHRL)
RS5F_GAGACTTTCGAGAAGC	EC-cells (TPH1)
RS5F_GAGACTTTCGTAACTG	M-X-cells (GHRL)
RS5F_GAGAGGTTCATGCGGC	M-X-cells (GHRL)
RS5F_GAGGGATAGTTAGAAC	EC-cells (TPH1)
RS5F_GAGTTTGTCCGAAATC	EC-cells (TPH1)
RS5F_GATAGAATCCCGGTAG	EC-cells (TPH1)
RS5F_GATCATGCATTAGGAA	EC-cells (TPH1)
RS5F_GATCGTAAGTCCCAGC	EC-cells (TPH1)
RS5F_GATTCGAAGTGATGGC	EC-cells (TPH1)
RS5F_GCAACATAGTCGGCAA	EC-cells (TPH1)
RS5F_GCAACCGGTGCTCGTG	M-X-cells (GHRL)
RS5F_GCACTAACATGCAGCC	EC-cells (TPH1)
RS5F_GCAGCCAAGCTACGTT	EC-cells (TPH1)
RS5F_GCAGTTAAGCCGAACA	EC-cells (TPH1)
RS5F_GCATTAGGTCCGAAAG	M-X-cells (GHRL)
RS5F_GCCAACGCATGCCATA	M-X-cells (GHRL)
RS5F_GCCAACGTCGCTTTAT	M-X-cells (GHRL)
RS5F_GCGGATCCATCCTGTC	EC-cells (TPH1)
RS5F_GCGGATCTCCGATAGT	EC-cells (TPH1)
RS5F_GCGTGCATCTGCCTGT	ECL-cells (HDC,MAOB)
RS5F_GCTACAACAGCTGAAG	M-X-cells (GHRL)
RS5F_GCTACAAGTCTCTCAC	EC-cells (TPH1)
RS5F_GCTACCTAGTTGGAGC	M-X-cells (GHRL)
RS5F_GCTCAAAAGTCGGCAA	M-X-cells (GHRL)
RS5F_GCTTTCGCAATGTTGC	EC-cells (TPH1)
RS5F_GGAGATGCAGCAGACA	ECL-cells (HDC,MAOB)
RS5F_GGCACGTAGCGCCCAT	EC-cells (TPH1)
RS5F_GGCGTCAAGCTTCATG	EC-cells (TPH1)
RS5F_GGCTGTGTCTCATTGT	M-X-cells (GHRL)
RS5F_GGGAGATCAAGTTTGC	EC-cells (TPH1)
RS5F_GGGTATTCATCCAATG	EC-cells (TPH1)
RS5F_GGGTATTGTGAGACGT	M-X-cells (GHRL)
RS5F_GGGTGTCCAGTTGTCA	M-X-cells (GHRL)
RS5F_GGGTGTCTCGCTACAA	EC-cells (TPH1)
RS5F_GGGTTTATCAAGATAG	M-X-cells (GHRL)
RS5F_GGTGGCTAGACGCAGT	EC-cells (TPH1)
RS5F_GTAAGTCCACAATGAA	EC-cells (TPH1)
RS5F_GTCTGTCGTATAGGGC	EC-cells (TPH1)
RS5F_GTGCACGCATCTGGGC	EC-cells (TPH1)
RS5F_GTGCTTCCAACGGTAG	EC-cells (TPH1)
RS5F_GTGTTCCTCTACCCAC	EC-cells (TPH1)
RS5F_GTTAGTGTCCCTCTAG	EC-cells (TPH1)
RS5F_GTTCTATTCATACGGT	EC-cells (TPH1)
RS5F_GTTGTGAGTGGCTAGA	M-X-cells (GHRL)
RS5F_GTTGTGATCCGGACTG	EC-cells (TPH1)
RS5F_GTTTGGAAGTTCAACC	M-X-cells (GHRL)
RS5F_TAACCAGCAAATACAG	EC-cells (TPH1)
RS5F_TAAGCCATCTTAATCC	M-X-cells (GHRL)
RS5F_TACCGAAGTGATCATC	M-X-cells (GHRL)
RS5F_TACCGAAGTTCGTGCG	M-X-cells (GHRL)
RS5F_TACCGAATCGTCACCT	EC-cells (TPH1)
RS5F_TACCGGGCAACCAACT	EC-cells (TPH1)
RS5F_TACGGTATCCGTATAG	EC-cells (TPH1)
RS5F_TACGGTATCTCAACGA	EC-cells (TPH1)
RS5F_TACGTCCCAATGAGCG	EC-cells (TPH1)
RS5F_TACGTCCGTATTGCCA	M-X-cells (GHRL)
RS5F_TACTTGTAGGTGCTAG	M-X-cells (GHRL)
RS5F_TAGACTGGTGTTAACC	M-X-cells (GHRL)
RS5F_TATACCTGTGGAGAAA	EC-cells (TPH1)
RS5F_TATATCCTCGGCTTGG	M-X-cells (GHRL)
RS5F_TATCAGGCAACAAGAT	EC-cells (TPH1)
RS5F_TCAATTCTCGGAACTT	EC-cells (TPH1)
RS5F_TCACACCCATAGCACT	EC-cells (TPH1)
RS5F_TCACGGGCATGCGTGC	M-X-cells (GHRL)
RS5F_TCAGCAACATATCTGG	EC-cells (TPH1)
RS5F_TCATATCTCTGCCTCA	EC-cells (TPH1)
RS5F_TCATTCATCCTACGGG	EC-cells (TPH1)
RS5F_TCCACCAAGACTCTTG	M-X-cells (GHRL)
RS5F_TCCAGAAGTCTTTCTA	EC-cells (TPH1)
RS5F_TCCCATGAGAAGGATG	EC-cells (TPH1)
RS5F_TCCGATCAGTGCGACA	M-X-cells (GHRL)
RS5F_TCCGATCCATAGGCGA	M-X-cells (GHRL)
RS5F_TCCGATCTCCTAACAG	EC-cells (TPH1)
RS5F_TCCGGGACAGACCGCT	M-X-cells (GHRL)
RS5F_TCCGTGTGTATGGTTC	EC-cells (TPH1)
RS5F_TCCTTTCCACCGGCTA	EC-cells (TPH1)
RS5F_TCGACCTCACATACTG	EC-cells (TPH1)
RS5F_TCGATTTCATTGAAAG	EC-cells (TPH1)
RS5F_TCGGATATCAGACAAA	EC-cells (TPH1)
RS5F_TCGTCCATCGATTCCC	M-X-cells (GHRL)
RS5F_TCTATACCACCCTGAG	EC-cells (TPH1)
RS5F_TCTCCGAGTCGCGTCA	EC-cells (TPH1)
RS5F_TCTGTCGAGATTGACA	M-X-cells (GHRL)
RS5F_TGACTCCGTGCCCGTA	EC-cells (TPH1)
RS5F_TGAGCATCAATACAGA	ECL-cells (HDC,MAOB)
RS5F_TGAGGTTGTAATTAGG	EC-cells (TPH1)
RS5F_TGAGTCAAGGCTTCCG	EC-cells (TPH1)
RS5F_TGAGTCACATAGTCGT	M-X-cells (GHRL)
RS5F_TGATGGTAGGTTCACT	EC-cells (TPH1)
RS5F_TGCATGAAGTATAGGT	EC-cells (TPH1)
RS5F_TGCGACGCATCCGATA	EC-cells (TPH1)
RS5F_TGCGACGCATTGTGCA	M-X-cells (GHRL)
RS5F_TGCGGGTCACATACTG	EC-cells (TPH1)
RS5F_TGCTCGTTCTCAACCC	EC-cells (TPH1)
RS5F_TGCTTCGCAGGTTACT	EC-cells (TPH1)
RS5F_TGGATCACAGATACTC	EC-cells (TPH1)
RS5F_TGGATCAGTGCTCTCT	EC-cells (TPH1)
RS5F_TGGGTTACACATGAAA	M-X-cells (GHRL)
RS5F_TGGTGATGTGCATCTA	EC-cells (TPH1)
RS5F_TGGTTAGGTGCTCTCT	EC-cells (TPH1)
RS5F_TGGTTAGTCGCTGATA	EC-cells (TPH1)
RS5F_TGTAACGTCCTTGGAA	EC-cells (TPH1)
RS5F_TGTCAGATCGCCTATC	EC-cells (TPH1)
RS5F_TGTGATGGTACTCCGG	EC-cells (TPH1)
RS5F_TGTGCGGCAATAGTAG	EC-cells (TPH1)
RS5F_TGTTACTTCGCTCTAC	EC-cells (TPH1)
RS5F_TGTTGAGTCCGCGAGT	EC-cells (TPH1)
RS5F_TTACGCCAGACCCGCT	EC-cells (TPH1)
RS5F_TTAGGGTCACAAACGG	EC-cells (TPH1)
RS5F_TTAGTCTAGGTGCAGT	EC-cells (TPH1)
RS5F_TTCTCTCGTGCAGTGA	EC-cells (TPH1)
RS5F_TTCTTCCGTGTCTAAC	EC-cells (TPH1)
RS5F_TTGAACGAGATGCTGG	EC-cells (TPH1)
RS5F_TTGAACGGTACTCGTA	EC-cells (TPH1)
RS5F_TTGAACGGTCACGACC	EC-cells (TPH1)
RS5F_TTGAGTGTCATGTCTT	EC-cells (TPH1)
RS5F_TTGGGCGAGGTGATAT	EC-cells (TPH1)
RS5F_TTGGGTAAGAGCATAT	EC-cells (TPH1)
RS5F_TTGGTTTTCTATCCAT	EC-cells (TPH1)
RS5F_TTGTTGTGTCCACGCA	M-X-cells (GHRL)
RS5F_TTTACTGTCATCGCTC	EC-cells (TPH1)
RS5F_TTTATGCCATGACCCG	EC-cells (TPH1)
RS5F_TTTGATCAGATGCGAC	EC-cells (TPH1)
RS5F_TTTGATCCAAAGGCTG	M-X-cells (GHRL)
RS6B_AAACGCTTCCATCGTC	M-X-cells (GHRL)
RS6B_AAAGTCCTCTGGCCTT	M-X-cells (GHRL)
RS6B_AACCCAAAGTGCAAAT	M-X-cells (GHRL)
RS6B_AACGAAAGTCAGCGTC	M-X-cells (GHRL)
RS6B_AACGGGAGTCGAACAG	ECL-cells (HDC,MAOB)
RS6B_AAGCCATGTGCTTATG	M-X-cells (GHRL)
RS6B_AAGTACCCAGTCGCAC	M-X-cells (GHRL)
RS6B_AATGCCACAAGCACCC	M-X-cells (GHRL)
RS6B_ACTTATCTCAGACCCG	ECL-cells (HDC,MAOB)
RS6B_AGAACCTGTCCCTGTT	M-X-cells (GHRL)
RS6B_AGCCAATAGTTCTACG	M-X-cells (GHRL)
RS6B_AGCGTATAGGAGGGTG	M-X-cells (GHRL)
RS6B_AGGTCTATCCGCACTT	ECL-cells (HDC,MAOB)
RS6B_AGTGTTGTCAACTACG	M-X-cells (GHRL)
RS6B_ATCACTTAGAACTCCT	ECL-cells (HDC,MAOB)
RS6B_ATGAGGGGTCTACTGA	M-X-cells (GHRL)
RS6B_ATGATCGAGCCTATTG	M-X-cells (GHRL)
RS6B_ATGCATGGTGGGTTGA	M-X-cells (GHRL)
RS6B_ATGGATCAGGTTCCAT	EC-cells (TPH1)
RS6B_ATTACCTAGGTGCTTT	M-X-cells (GHRL)
RS6B_ATTCAGGTCCGGACGT	ECL-cells (HDC,MAOB)
RS6B_CAAGAGGAGTAAGAGG	M-X-cells (GHRL)
RS6B_CACAGGCGTTGACTGT	ECL-cells (HDC,MAOB)
RS6B_CACTTCGAGAGTCGAC	ECL-cells (HDC,MAOB)
RS6B_CAGCACGGTCCAGTTA	EC-cells (TPH1)
RS6B_CAGGGCTGTTGAGTCT	M-X-cells (GHRL)
RS6B_CATCGCTCAACAGCTT	M-X-cells (GHRL)
RS6B_CATGCCTGTTGGACTT	M-X-cells (GHRL)
RS6B_CATGGATGTGAGGCAT	ECL-cells (HDC,MAOB)
RS6B_CCACACTTCTAGCAAC	M-X-cells (GHRL)
RS6B_CCCATTGAGCTCCACG	M-X-cells (GHRL)
RS6B_CCCTGATTCGCTAAAC	M-X-cells (GHRL)
RS6B_CCCTTAGAGCTGGCTC	M-X-cells (GHRL)
RS6B_CCTCTAGAGATAACAC	ECL-cells (HDC,MAOB)
RS6B_CGTAAGTTCCTAGAGT	M-X-cells (GHRL)
RS6B_CTCATGCGTCTACAAC	M-X-cells (GHRL)
RS6B_CTCATGCTCACATCAG	M-X-cells (GHRL)
RS6B_CTCGAGGGTGTCCGGT	M-X-cells (GHRL)
RS6B_CTGTAGAGTATTGAGA	ECL-cells (HDC,MAOB)
RS6B_CTTCCGAAGCTGAAGC	ECL-cells (HDC,MAOB)
RS6B_CTTGAGACATCGGTTA	ECL-cells (HDC,MAOB)
RS6B_GAAACCTAGGATGAGA	M-X-cells (GHRL)
RS6B_GAATCGTAGGGCCCTT	M-X-cells (GHRL)
RS6B_GACCCAGAGTCTGGTT	M-X-cells (GHRL)
RS6B_GAGGGATAGTACCCTA	ECL-cells (HDC,MAOB)
RS6B_GAGTTACGTAACGGTG	M-X-cells (GHRL)
RS6B_GCAGCTGCAGTCTACA	ECL-cells (HDC,MAOB)
RS6B_GCTGGGTGTGCATGAG	M-X-cells (GHRL)
RS6B_GGTAATCAGGATGAGA	ECL-cells (HDC,MAOB)
RS6B_GTAGAGGAGCTGGCCT	ECL-cells (HDC,MAOB)
RS6B_GTAGTACCACGATTCA	M-X-cells (GHRL)
RS6B_GTCACGGGTAGCGTTT	M-X-cells (GHRL)
RS6B_GTGTAACGTGCTCTCT	M-X-cells (GHRL)
RS6B_GTGTTAGCACTGCTTC	M-X-cells (GHRL)
RS6B_GTTTACTAGGTAGACC	M-X-cells (GHRL)
RS6B_TCAGGTATCTCTAGGA	M-X-cells (GHRL)
RS6B_TCATGCCTCATCGCAA	ECL-cells (HDC,MAOB)
RS6B_TCCCACAGTAAGTTAG	ECL-cells (HDC,MAOB)
RS6B_TCCGGGATCTCTTCAA	M-X-cells (GHRL)
RS6B_TCGCTTGTCCTACAAG	M-X-cells (GHRL)
RS6B_TCGGTCTCACCTTCCA	M-X-cells (GHRL)
RS6B_TCTCTGGAGAGTCAGC	M-X-cells (GHRL)
RS6B_TGCGGCACACAATGTC	ECL-cells (HDC,MAOB)
RS6B_TGCTCGTGTCTTAGTG	M-X-cells (GHRL)
RS6B_TGGGAAGAGCAGGCTA	M-X-cells (GHRL)
RS6B_TGTCCTGTCCTCTCGA	M-X-cells (GHRL)
RS6B_TGTTCTATCCGCTGTT	M-X-cells (GHRL)
RS6B_TTCCAATCAGTCTCTC	M-X-cells (GHRL)
RS6B_TTCCTAATCACCGACG	M-X-cells (GHRL)
RS6B_TTTGTTGAGCTACGTT	EC-cells (TPH1)
RS6F_AAAGGTAGTCGCTTAA	ECL-cells (HDC,MAOB)
RS6F_AACAAAGCACTGGCGT	EC-cells (TPH1)
RS6F_AACCTGAAGGCTTCCG	M-X-cells (GHRL)
RS6F_AACCTGATCGACCCAG	M-X-cells (GHRL)
RS6F_AAGAACATCTGAATCG	EC-cells (TPH1)
RS6F_AAGATAGAGTCCTGTA	M-X-cells (GHRL)
RS6F_AAGGAATGTCCACAGC	EC-cells (TPH1)
RS6F_AAGTACCAGCCTATCA	ECL-cells (HDC,MAOB)
RS6F_AAGTACCGTTTACTTC	M-X-cells (GHRL)
RS6F_AAGTGAACAGTGACCC	M-X-cells (GHRL)
RS6F_AAGTTCGCAATGAGCG	M-X-cells (GHRL)
RS6F_ACAACCAGTAAGGAGA	M-X-cells (GHRL)
RS6F_ACAGAAACAGACCTAT	M-X-cells (GHRL)
RS6F_ACATCGAAGGACAAGA	M-X-cells (GHRL)
RS6F_ACGATCAAGCATAGGC	M-X-cells (GHRL)
RS6F_ACGGTTAAGTCCTGCG	ECL-cells (HDC,MAOB)
RS6F_ACGTCCTTCATTGCCC	M-X-cells (GHRL)
RS6F_ACTTTCAGTTGTCATG	EC-cells (TPH1)
RS6F_AGAACAACACCATTCC	M-X-cells (GHRL)
RS6F_AGACCCGGTATGATCC	ECL-cells (HDC,MAOB)
RS6F_AGATAGAAGACATGCG	M-X-cells (GHRL)
RS6F_AGATGAACATGACGAG	M-X-cells (GHRL)
RS6F_AGCATCACAAGAGCTG	M-X-cells (GHRL)
RS6F_AGGTGTTGTACTCGCG	M-X-cells (GHRL)
RS6F_AGTACTGGTAATGCTC	M-X-cells (GHRL)
RS6F_AGTGATCTCGATACAC	ECL-cells (HDC,MAOB)
RS6F_ATCACAGAGAGTGTGC	ECL-cells (HDC,MAOB)
RS6F_ATCACGAAGCTAGTTC	EC-cells (TPH1)
RS6F_ATGACCACACAGTACT	M-X-cells (GHRL)
RS6F_ATGATCGCACGACGAA	EC-cells (TPH1)
RS6F_ATGCCTCCAGGATCTT	M-X-cells (GHRL)
RS6F_ATGCGATAGAAGCCTG	M-X-cells (GHRL)
RS6F_CAACGGCTCGAGTACT	M-X-cells (GHRL)
RS6F_CACAGATCATCCCGTT	M-X-cells (GHRL)
RS6F_CACATGATCCGTGGGT	M-X-cells (GHRL)
RS6F_CACGTGGAGCCGATCC	M-X-cells (GHRL)
RS6F_CAGGGCTAGTTGAAAC	M-X-cells (GHRL)
RS6F_CAGGGCTTCTTCCCGA	ECL-cells (HDC,MAOB)
RS6F_CCACCATGTTGCATTG	ECL-cells (HDC,MAOB)
RS6F_CCCAACTTCCCAAGCG	M-X-cells (GHRL)
RS6F_CCGTAGGAGCAGGCAT	M-X-cells (GHRL)
RS6F_CCTCCTCCACAGTATC	ECL-cells (HDC,MAOB)
RS6F_CCTTTGGCACTGAGTT	M-X-cells (GHRL)
RS6F_CCTTTGGCACTTCAGA	M-X-cells (GHRL)
RS6F_CGAGAAGCAGGCTACC	EC-cells (TPH1)
RS6F_CGATGCGAGACCTCAT	M-X-cells (GHRL)
RS6F_CGCATAATCTGAACGT	M-X-cells (GHRL)
RS6F_CGGCAGTAGGAAAGTG	M-X-cells (GHRL)
RS6F_CTAAGTGAGCAACAAT	ECL-cells (HDC,MAOB)
RS6F_CTACAGATCGCTTACC	M-X-cells (GHRL)
RS6F_CTACCCATCGTACCTC	M-X-cells (GHRL)
RS6F_CTACCTGCAGCAAGAC	EC-cells (TPH1)
RS6F_CTATCTAAGAAGTCAT	M-X-cells (GHRL)
RS6F_CTCAGAAGTACCGGAA	M-X-cells (GHRL)
RS6F_CTCCACAAGTCAATCC	EC-cells (TPH1)
RS6F_CTCCGATAGCCTGAGA	M-X-cells (GHRL)
RS6F_CTCCTCCGTGGTCTAT	M-X-cells (GHRL)
RS6F_CTGCATCAGATGCAGC	M-X-cells (GHRL)
RS6F_CTTCTAATCATGAGGG	EC-cells (TPH1)
RS6F_CTTGAGATCGGCTGTG	M-X-cells (GHRL)
RS6F_GACTCTCGTCTACGAT	M-X-cells (GHRL)
RS6F_GAGAAATCAGACGATG	M-X-cells (GHRL)
RS6F_GAGATGGCAGTTGAAA	M-X-cells (GHRL)
RS6F_GAGCTGCCATCGATGT	EC-cells (TPH1)
RS6F_GAGGGATCAAGTGACG	ECL-cells (HDC,MAOB)
RS6F_GAGTTACAGAGCCCAA	EC-cells (TPH1)
RS6F_GATAGAACAAAGGCGT	M-X-cells (GHRL)
RS6F_GATGATCCACTCATAG	M-X-cells (GHRL)
RS6F_GATTCTTGTTGCACGC	ECL-cells (HDC,MAOB)
RS6F_GCAACATAGCAACAAT	ECL-cells (HDC,MAOB)
RS6F_GCAACATAGGGAGATA	ECL-cells (HDC,MAOB)
RS6F_GCATCTCCACTACAGT	M-X-cells (GHRL)
RS6F_GCCAGGTTCTGGTGGC	M-X-cells (GHRL)
RS6F_GCCCAGATCATGCGGC	M-X-cells (GHRL)
RS6F_GCCGTGAGTCTTTATC	M-X-cells (GHRL)
RS6F_GCTACCTCACTGCGTG	EC-cells (TPH1)
RS6F_GCTGCAGTCAGTCATG	M-X-cells (GHRL)
RS6F_GGAGGATCATGACCCG	ECL-cells (HDC,MAOB)
RS6F_GGCTGTGAGGCATGGT	EC-cells (TPH1)
RS6F_GGGACCTTCCGTTGAA	M-X-cells (GHRL)
RS6F_GGTAACTAGATAACAC	M-X-cells (GHRL)
RS6F_GGTAATCCATACTGAC	M-X-cells (GHRL)
RS6F_GGTGATTGTAGCGTAG	M-X-cells (GHRL)
RS6F_GTCAAACCATTACTCT	M-X-cells (GHRL)
RS6F_GTCATCCAGCCTATTG	M-X-cells (GHRL)
RS6F_GTGACGCCACCATAAC	M-X-cells (GHRL)
RS6F_GTGAGTTCAGGTGTTT	M-X-cells (GHRL)
RS6F_GTGAGTTGTGATACTC	M-X-cells (GHRL)
RS6F_GTGGCGTAGTCGGGAT	M-X-cells (GHRL)
RS6F_GTGGTTATCTGTCCCA	M-X-cells (GHRL)
RS6F_GTGTAACAGGCTGGAT	ECL-cells (HDC,MAOB)
RS6F_GTTCCGTAGTCTACCA	ECL-cells (HDC,MAOB)
RS6F_GTTGCTCGTCATTGCA	ECL-cells (HDC,MAOB)
RS6F_GTTGCTCGTTAATGAG	M-X-cells (GHRL)
RS6F_TAAGCACGTAGTCACT	M-X-cells (GHRL)
RS6F_TACAGGTCACACACTA	ECL-cells (HDC,MAOB)
RS6F_TACGGGCCATGGACAG	M-X-cells (GHRL)
RS6F_TACTGCCTCTATGTGG	M-X-cells (GHRL)
RS6F_TAGACTGTCCGTGTAA	EC-cells (TPH1)
RS6F_TCAGGTATCATCACAG	EC-cells (TPH1)
RS6F_TCCCATGTCACCTTAT	ECL-cells (HDC,MAOB)
RS6F_TCCGATCGTGCAATGG	M-X-cells (GHRL)
RS6F_TCCTGCATCGCTTGAA	M-X-cells (GHRL)
RS6F_TCGAACATCTTGCAGA	ECL-cells (HDC,MAOB)
RS6F_TCGCTCAAGTCAATCC	M-X-cells (GHRL)
RS6F_TCGCTTGGTATAGGGC	M-X-cells (GHRL)
RS6F_TCGGGTGGTTCCATTT	ECL-cells (HDC,MAOB)
RS6F_TGATGCAAGGTTTACC	M-X-cells (GHRL)
RS6F_TGCAGATGTGAGTTTC	ECL-cells (HDC,MAOB)
RS6F_TGCGACGAGGATGTTA	M-X-cells (GHRL)
RS6F_TGGGCTGCAAACGGCA	M-X-cells (GHRL)
RS6F_TTAGGGTTCTCTAAGG	M-X-cells (GHRL)
RS6F_TTATTGCCAACGGCCT	M-X-cells (GHRL)
RS6F_TTCCACGAGTAACGAT	M-X-cells (GHRL)
RS6F_TTCCTAATCGGATACT	M-X-cells (GHRL)
RS6F_TTCCTCTAGGGTCAAC	ECL-cells (HDC,MAOB)
RS6F_TTGAGTGCACGACGAA	ECL-cells (HDC,MAOB)
RS6F_TTGGGATGTCGAACAG	M-X-cells (GHRL)
RS6F_TTGGGTATCTCGCTCA	M-X-cells (GHRL)
RS6F_TTTACCAAGTAGTCCT	M-X-cells (GHRL)
RS6F_TTTCGATGTATGCGTT	M-X-cells (GHRL)
RS6F_TTTGACTCAGCTACCG	M-X-cells (GHRL)
RS7B_ACATCGATCCATTCGC	ECL-cells (HDC,MAOB)
RS7B_ACTTCCGGTGTTTACG	ECL-cells (HDC,MAOB)
RS7B_AGACAGGGTCTAGGCC	M-X-cells (GHRL)
RS7B_AGCCAATAGAATTGTG	M-X-cells (GHRL)
RS7B_ATTACCTTCTAAGAAG	M-X-cells (GHRL)
RS7B_ATTACTCCACCTTCGT	ECL-cells (HDC,MAOB)
RS7B_CAGCACGCATGCTGCG	M-X-cells (GHRL)
RS7B_CAGGTATTCTTGCAGA	M-X-cells (GHRL)
RS7B_CCTATCGAGCTTTCCC	M-X-cells (GHRL)
RS7B_CCTCAACGTCTGATAC	M-X-cells (GHRL)
RS7B_CTCCACACAAGATTGA	M-X-cells (GHRL)
RS7B_CTTAGGATCACTACGA	M-X-cells (GHRL)
RS7B_GTAGAAACACTGTCGG	M-X-cells (GHRL)
RS7B_GTAGGTTCATTGCCTC	EC-cells (TPH1)
RS7B_GTATTGGGTTACTCAG	ECL-cells (HDC,MAOB)
RS7B_GTCGTTCTCTTTGCGC	M-X-cells (GHRL)
RS7B_TACAGGTAGCAATTAG	M-X-cells (GHRL)
RS7B_TCGTGCTGTCAAGCGA	M-X-cells (GHRL)
RS7B_TGGTACATCTCGCGTT	M-X-cells (GHRL)
RS7B_TGTCCCACATAAGCAA	M-X-cells (GHRL)
RS7B_TGTGAGTGTCATAACC	M-X-cells (GHRL)
RS7B_TGTTCATAGTGGAAAG	M-X-cells (GHRL)
RS7B_TTAGGCATCTCGGCTT	M-X-cells (GHRL)
RS7B_TTCGGTCAGTGGCCTC	M-X-cells (GHRL)
RS7B_TTGTGTTTCGTCAGAT	M-X-cells (GHRL)
RS7F_AACCATGGTCGGTGAA	M-X-cells (GHRL)
RS7F_AACTTCTCACTGAGTT	EC-cells (TPH1)
RS7F_AATAGAGTCTGCTCTG	M-X-cells (GHRL)
RS7F_AATGGCTAGAGAGGTA	M-X-cells (GHRL)
RS7F_ACAGCCGGTATCAAGA	M-X-cells (GHRL)
RS7F_ACTGTGAAGACTCATC	M-X-cells (GHRL)
RS7F_ACTTAGGCATCAACCA	ECL-cells (HDC,MAOB)
RS7F_ACTTAGGTCAGGAAGC	M-X-cells (GHRL)
RS7F_AGGATCTAGCGCCCAT	M-X-cells (GHRL)
RS7F_AGGTCATAGTGAGCCA	M-X-cells (GHRL)
RS7F_AGGTCTAGTATGCGGA	M-X-cells (GHRL)
RS7F_AGGTGTTGTGTTACAC	EC-cells (TPH1)
RS7F_ATGCCTCGTGGAAGTC	M-X-cells (GHRL)
RS7F_CAACGGCAGGTGTGAC	M-X-cells (GHRL)
RS7F_CAGCAATAGTTTGAGA	M-X-cells (GHRL)
RS7F_CAGCACGCAAGCCCAC	EC-cells (TPH1)
RS7F_CATCAAGAGTAACGAT	M-X-cells (GHRL)
RS7F_CCGGACATCTCTATGT	M-X-cells (GHRL)
RS7F_CGAGTGCCACCATTCC	M-X-cells (GHRL)
RS7F_CGTAATGAGCGTTAGG	ECL-cells (HDC,MAOB)
RS7F_CTCATTAGTTGTCAGT	M-X-cells (GHRL)
RS7F_GAAGAATAGGATCATA	M-X-cells (GHRL)
RS7F_GAGTCTATCCGTTGAA	M-X-cells (GHRL)
RS7F_GATAGAATCAAGCCTA	M-X-cells (GHRL)
RS7F_GATGATCCACAACGCC	M-X-cells (GHRL)
RS7F_GCTGCAGCAACTAGAA	M-X-cells (GHRL)
RS7F_GGGCGTTTCCATTGCC	M-X-cells (GHRL)
RS7F_GGTAACTGTGCCCGTA	ECL-cells (HDC,MAOB)
RS7F_GGTGTTAAGGATCATA	M-X-cells (GHRL)
RS7F_GTACAGTCAGTACTAC	M-X-cells (GHRL)
RS7F_TCAATCTAGCAACCAG	M-X-cells (GHRL)
RS7F_TCACAAGAGAGCAACC	M-X-cells (GHRL)
RS7F_TCATTCAAGTCACTGT	M-X-cells (GHRL)
RS7F_TCGGGCATCGCAGTCG	M-X-cells (GHRL)
RS7F_TCTACCGCATGCACTA	EC-cells (TPH1)
RS7F_TGACAGTGTTTACACG	M-X-cells (GHRL)
RS7F_TGCACGGCAACCTAAC	M-X-cells (GHRL)
RS7F_TGGAACTGTCTCCCTA	M-X-cells (GHRL)
RS7F_TGGGTTAGTCTCACAA	M-X-cells (GHRL)
RS7F_TGTGCGGCATGGGCAA	ECL-cells (HDC,MAOB)
RS7F_TGTGTGACAGGATTCT	M-X-cells (GHRL)
RS7F_TGTGTGAGTTCAGTAC	M-X-cells (GHRL)
RS7F_TTAATCCGTCATCTAG	M-X-cells (GHRL)
RS7F_TTAGGGTGTCAACATC	M-X-cells (GHRL)
RS7F_TTCATTGTCTTTCCAA	M-X-cells (GHRL)
RS7F_TTCCACGTCCGCTTAC	M-X-cells (GHRL)
RS7F_TTCCTAAAGAGTTGAT	M-X-cells (GHRL)
RS7F_TTCCTAACAGTGTGCC	M-X-cells (GHRL)
RS7F_TTCTTGACACTGAGTT	M-X-cells (GHRL)
RS7F_TTTAGTCGTTAGGCTT	M-X-cells (GHRL)
RS7F_TTTATGCGTGTTCGAT	M-X-cells (GHRL)
RS9B_ATGCATGGTTAGGACG	M-X-cells (GHRL)
RS9B_GGTTAACCAGGTCAAG	M-X-cells (GHRL)
RS9B_GTTGTAGCAAATACAG	M-X-cells (GHRL)
RS10B_AAATGGAAGGATTCCT	EC-cells (TPH1)
RS10B_AACAACCCAGCAGTGA	EC-cells (TPH1)
RS10B_AACAGGGAGTGTACAA	M-X-cells (GHRL)
RS10B_AAGATAGAGCGAATGC	EC-cells (TPH1)
RS10B_AAGCCATTCGAGTCCG	EC-cells (TPH1)
RS10B_AAGGAATTCCATTTAC	EC-cells (TPH1)
RS10B_ACATGCATCCGATCTC	EC-cells (TPH1)
RS10B_ACCAACAAGATGCAGC	EC-cells (TPH1)
RS10B_ACCTGTCCAGATAAAC	M-X-cells (GHRL)
RS10B_ACGTCCTCACTACCGG	ECL-cells (HDC,MAOB)
RS10B_ACTCCCACAAGAATAC	ECL-cells (HDC,MAOB)
RS10B_ACTGTCCGTGACTCTA	EC-cells (TPH1)
RS10B_ACTTAGGAGTGCACTT	ECL-cells (HDC,MAOB)
RS10B_AGCGCTGGTAGGCTCC	EC-cells (TPH1)
RS10B_AGGAAATCATAAGCGG	EC-cells (TPH1)
RS10B_AGGATAACAAGAGATT	M-X-cells (GHRL)
RS10B_AGGTCATGTATTTCGG	EC-cells (TPH1)
RS10B_ATCCGTCCACTGAATC	EC-cells (TPH1)
RS10B_ATGACCAAGCTCATAC	ECL-cells (HDC,MAOB)
RS10B_ATGATCGAGTATGCAA	ECL-cells (HDC,MAOB)
RS10B_ATTCCTAAGTAGGCCA	ECL-cells (HDC,MAOB)
RS10B_ATTCTTGCAGTGGCTC	EC-cells (TPH1)
RS10B_ATTTACCAGACGAAGA	EC-cells (TPH1)
RS10B_CAACAGTAGAAGTCCG	EC-cells (TPH1)
RS10B_CAACAGTCAGTTCACA	EC-cells (TPH1)
RS10B_CAACGATCAGGTTTAC	EC-cells (TPH1)
RS10B_CAAGCTATCAACTCTT	EC-cells (TPH1)
RS10B_CAAGGGAGTGTCTTAG	EC-cells (TPH1)
RS10B_CACATGATCGGAATGG	M-X-cells (GHRL)
RS10B_CAGATTGGTAGGGAGG	EC-cells (TPH1)
RS10B_CATCGCTCACCCTCTA	EC-cells (TPH1)
RS10B_CATCGGGTCAACCCGG	ECL-cells (HDC,MAOB)
RS10B_CATGGATGTACTGTTG	EC-cells (TPH1)
RS10B_CCCATTGCAGGATGAC	EC-cells (TPH1)
RS10B_CCCTGATGTTCCATTT	EC-cells (TPH1)
RS10B_CCTGTTGCACTGGAAG	EC-cells (TPH1)
RS10B_CCTGTTGCAGCAGACA	EC-cells (TPH1)
RS10B_CCTTCAGGTACCGGAA	M-X-cells (GHRL)
RS10B_CCTTGTGTCCGATCGG	M-X-cells (GHRL)
RS10B_CGGCAGTGTCACTTCC	M-X-cells (GHRL)
RS10B_CGGGCATAGTGTTGAA	ECL-cells (HDC,MAOB)
RS10B_CTACAGACACTTCAGA	EC-cells (TPH1)
RS10B_CTCGAGGGTATGTCTG	M-X-cells (GHRL)
RS10B_CTGCGAGAGCTCTATG	EC-cells (TPH1)
RS10B_CTGCGAGTCCTGGCTT	EC-cells (TPH1)
RS10B_CTGCTCACAACTGCTA	EC-cells (TPH1)
RS10B_CTGCTCATCGTGGGAA	M-X-cells (GHRL)
RS10B_CTGTGGGAGTCCCTAA	EC-cells (TPH1)
RS10B_CTTCTCTTCGTCTACC	EC-cells (TPH1)
RS10B_GAACTGTGTACACGCC	M-X-cells (GHRL)
RS10B_GAAGCGAGTTCTCGTC	M-X-cells (GHRL)
RS10B_GAAGTAATCGTTTACT	M-X-cells (GHRL)
RS10B_GACCCTTCAGTTTCGA	M-X-cells (GHRL)
RS10B_GAGGCAAAGCGGTATG	EC-cells (TPH1)
RS10B_GAGGCCTCAAGCCATT	EC-cells (TPH1)
RS10B_GAGTTACAGTAAACAC	ECL-cells (HDC,MAOB)
RS10B_GATTCGATCCAGTGCG	EC-cells (TPH1)
RS10B_GATTCTTCACCGTGCA	M-X-cells (GHRL)
RS10B_GATTGGTAGGCATCAG	M-X-cells (GHRL)
RS10B_GATTTCTCAGGATCTT	ECL-cells (HDC,MAOB)
RS10B_GATTTCTCATCCCACT	M-X-cells (GHRL)
RS10B_GCAACCGCACGGATCC	EC-cells (TPH1)
RS10B_GCAGTTATCTCTCAAT	M-X-cells (GHRL)
RS10B_GCATTAGGTACTAGCT	EC-cells (TPH1)
RS10B_GCCATGGAGTCGGCCT	EC-cells (TPH1)
RS10B_GCCATGGTCTTGCGCT	EC-cells (TPH1)
RS10B_GGAGGTAGTCCATACA	ECL-cells (HDC,MAOB)
RS10B_GGGACTCGTAAGATAC	EC-cells (TPH1)
RS10B_GGGTGAATCTCTCAAT	M-X-cells (GHRL)
RS10B_GGGTGTCTCAGAGTTC	ECL-cells (HDC,MAOB)
RS10B_GGGTTTACACACAGCC	M-X-cells (GHRL)
RS10B_GTAACCATCAGCTCTC	ECL-cells (HDC,MAOB)
RS10B_GTCATGACAGTTGTCA	EC-cells (TPH1)
RS10B_GTCGCGAGTATGCAAA	EC-cells (TPH1)
RS10B_GTGACGCGTAGACAGC	M-X-cells (GHRL)
RS10B_GTGAGGACAAGTGGCA	EC-cells (TPH1)
RS10B_GTGCACGGTTAACAGA	ECL-cells (HDC,MAOB)
RS10B_GTGCTTCCATGTGCCG	M-X-cells (GHRL)
RS10B_GTGTGATCATTAAGCC	M-X-cells (GHRL)
RS10B_GTTACGAGTCGTCTCT	EC-cells (TPH1)
RS10B_GTTGTGATCGCTGATA	M-X-cells (GHRL)
RS10B_TACTTCACACTCATAG	M-X-cells (GHRL)
RS10B_TATATCCAGATTAGCA	EC-cells (TPH1)
RS10B_TATATCCCACCTGCAG	EC-cells (TPH1)
RS10B_TCACACCGTGCAGTGA	EC-cells (TPH1)
RS10B_TCAGGGCAGCTCGAAG	EC-cells (TPH1)
RS10B_TCAGTTTCAGAGGACT	EC-cells (TPH1)
RS10B_TCCCACACATGGAGAC	EC-cells (TPH1)
RS10B_TCCTGCATCTTCGACC	EC-cells (TPH1)
RS10B_TCGCTTGAGTTGAAGT	EC-cells (TPH1)
RS10B_TCGCTTGTCACCGCTT	M-X-cells (GHRL)
RS10B_TCGGATAGTGTCATGT	M-X-cells (GHRL)
RS10B_TCTATACCAACGCATT	ECL-cells (HDC,MAOB)
RS10B_TCTCACGAGTTATGGA	EC-cells (TPH1)
RS10B_TCTGCCACACACAGAG	M-X-cells (GHRL)
RS10B_TCTGGCTGTCATCCCT	EC-cells (TPH1)
RS10B_TGATTTCTCGACGAGA	M-X-cells (GHRL)
RS10B_TGCAGGCAGACCAGAC	M-X-cells (GHRL)
RS10B_TGGAGAGTCGCCTTTG	EC-cells (TPH1)
RS10B_TGGGAAGAGCAGTACG	EC-cells (TPH1)
RS10B_TGTCCCATCGCATTGA	M-X-cells (GHRL)
RS10B_TGTTGGACAACCAATC	M-X-cells (GHRL)
RS10B_TTAGTCTCAATCCTTT	EC-cells (TPH1)
RS10B_TTCCTCTCACTCTGCT	EC-cells (TPH1)
RS10B_TTCCTCTCAGGAGGAG	M-X-cells (GHRL)
RS10B_TTCTCTCCATGACTCA	M-X-cells (GHRL)
RS10B_TTGTTCAGTATCAGCT	M-X-cells (GHRL)
RS10B_TTTGACTTCTACACAG	ECL-cells (HDC,MAOB)
RS10F_AAACGAACATACTGAC	M-X-cells (GHRL)
RS10F_AAAGGTATCGCTTACC	EC-cells (TPH1)
RS10F_AACAAGAAGCGTCAAG	EC-cells (TPH1)
RS10F_AACCAACGTATCACCA	M-X-cells (GHRL)
RS10F_AAGACTCTCGTAATGC	M-X-cells (GHRL)
RS10F_ACGTTCCGTCCACAGC	EC-cells (TPH1)
RS10F_AGACCATAGCCTGTCG	ECL-cells (HDC,MAOB)
RS10F_AGAGAATAGGATATAC	M-X-cells (GHRL)
RS10F_AGCTACACACGCGTCA	EC-cells (TPH1)
RS10F_AGCTCAATCCATAGGT	M-X-cells (GHRL)
RS10F_AGGCATTAGGCTCTAT	EC-cells (TPH1)
RS10F_AGGCATTGTACCCGCA	M-X-cells (GHRL)
RS10F_AGGTGTTCACAGCTGC	EC-cells (TPH1)
RS10F_AGTACCACACAGCTGC	M-X-cells (GHRL)
RS10F_AGTACCATCTTCGCTG	EC-cells (TPH1)
RS10F_ATGAAAGAGCGGACAT	EC-cells (TPH1)
RS10F_ATGACCACATCCGGCA	M-X-cells (GHRL)
RS10F_ATGTCCCTCAAAGACA	EC-cells (TPH1)
RS10F_ATTGTTCTCGACATAC	EC-cells (TPH1)
RS10F_CAACCTCGTGACTATC	EC-cells (TPH1)
RS10F_CACAGATGTCGAACAG	M-X-cells (GHRL)
RS10F_CACGGGTGTATAGGAT	EC-cells (TPH1)
RS10F_CAGCAGCCAACAGAGC	M-X-cells (GHRL)
RS10F_CAGTTCCCATGGAATA	EC-cells (TPH1)
RS10F_CATTGAGCAATAACGA	EC-cells (TPH1)
RS10F_CGAGTGCAGCTATCCA	EC-cells (TPH1)
RS10F_CGATGCGTCCAAACCA	ECL-cells (HDC,MAOB)
RS10F_CGATGGCCACAAGCTT	EC-cells (TPH1)
RS10F_CGTAATGAGGCTTCCG	M-X-cells (GHRL)
RS10F_CTACCTGGTGATACTC	EC-cells (TPH1)
RS10F_CTAGGTAGTAGGTCAG	M-X-cells (GHRL)
RS10F_CTATCTAGTAACAGTA	EC-cells (TPH1)
RS10F_CTCAGTCCATGGTGGA	ECL-cells (HDC,MAOB)
RS10F_CTCATCGGTTGGACCC	ECL-cells (HDC,MAOB)
RS10F_CTCCAACTCATACAGC	M-X-cells (GHRL)
RS10F_CTCCCAAGTTCTCAGA	ECL-cells (HDC,MAOB)
RS10F_CTCGAGGCAATACGCT	M-X-cells (GHRL)
RS10F_CTCGAGGTCGAGCTGC	ECL-cells (HDC,MAOB)
RS10F_CTGCAGGGTATCGCTA	EC-cells (TPH1)
RS10F_CTGCCATTCCGTGGTG	M-X-cells (GHRL)
RS10F_CTGGCAGAGAGGCCAT	M-X-cells (GHRL)
RS10F_CTTCCTTAGGCATTTC	M-X-cells (GHRL)
RS10F_CTTCCTTCATGGACAG	EC-cells (TPH1)
RS10F_CTTCTCTTCTTCGACC	EC-cells (TPH1)
RS10F_GACTGATTCTAGACAC	ECL-cells (HDC,MAOB)
RS10F_GAGTTGTGTAAGCTCT	EC-cells (TPH1)
RS10F_GATCGTAGTTTACTTC	EC-cells (TPH1)
RS10F_GATGAGGCATAGATGA	M-X-cells (GHRL)
RS10F_GCATTAGCACAGCCTG	EC-cells (TPH1)
RS10F_GCATTAGTCGGAATTC	ECL-cells (HDC,MAOB)
RS10F_GCCTGTTTCCAAGCTA	M-X-cells (GHRL)
RS10F_GCTGAATGTTCCGCAG	M-X-cells (GHRL)
RS10F_GCTTGGGTCATTGGTG	EC-cells (TPH1)
RS10F_GGAACCCGTTCGGTAT	EC-cells (TPH1)
RS10F_GGGTGAAGTTCGAGCC	M-X-cells (GHRL)
RS10F_GTAGAAATCTCAGGCG	EC-cells (TPH1)
RS10F_GTAGGAGAGGAACTAT	ECL-cells (HDC,MAOB)
RS10F_GTAGGTTGTAAGTAGT	EC-cells (TPH1)
RS10F_GTAGGTTTCAGGACAG	ECL-cells (HDC,MAOB)
RS10F_GTGAGGACACATATGC	EC-cells (TPH1)
RS10F_GTGAGTTAGTGCGCTC	EC-cells (TPH1)
RS10F_GTGGTTATCAGACCCG	EC-cells (TPH1)
RS10F_GTTAGTGCACCATATG	M-X-cells (GHRL)
RS10F_TAACCAGGTCTACTGA	EC-cells (TPH1)
RS10F_TAACGACCACACACTA	M-X-cells (GHRL)
RS10F_TAAGCGTTCTATTGTC	M-X-cells (GHRL)
RS10F_TACACCCAGGCAGCTA	EC-cells (TPH1)
RS10F_TACCGAATCTACGCGG	EC-cells (TPH1)
RS10F_TACTGCCGTTGGGATG	EC-cells (TPH1)
RS10F_TAGACTGCATAAGCGG	M-X-cells (GHRL)
RS10F_TATCGCCAGTGGTTCT	M-X-cells (GHRL)
RS10F_TCAAGTGTCCCTCTCC	ECL-cells (HDC,MAOB)
RS10F_TCAGTTTAGGAGAGGC	M-X-cells (GHRL)
RS10F_TCCACGTAGTTCCTGA	ECL-cells (HDC,MAOB)
RS10F_TCCTCGAAGGCCTTCG	M-X-cells (GHRL)
RS10F_TCCTTTCCATGAGTAA	EC-cells (TPH1)
RS10F_TCGACCTCATCGATGT	EC-cells (TPH1)
RS10F_TCTCTGGCACTGTTCC	M-X-cells (GHRL)
RS10F_TCTTCCTCAACTCCCT	EC-cells (TPH1)
RS10F_TCTTGCGGTTGTACGT	ECL-cells (HDC,MAOB)
RS10F_TGAATGCGTGTGCCTG	EC-cells (TPH1)
RS10F_TGAGACTAGCACCGTC	ECL-cells (HDC,MAOB)
RS10F_TGGATCATCGCTCCTA	M-X-cells (GHRL)
RS10F_TGGGTTAAGAAAGTCT	EC-cells (TPH1)
RS10F_TGTGAGTCAGCGCGTT	EC-cells (TPH1)
RS10F_TGTTCTACAGTACTAC	EC-cells (TPH1)
RS10F_TGTTCTAGTGGCGTAA	M-X-cells (GHRL)
RS10F_TTACTGTGTCTCACAA	EC-cells (TPH1)
RS10F_TTCAGGAGTCAGGTAG	EC-cells (TPH1)
RS10F_TTCCACGTCTGGGCAC	EC-cells (TPH1)
RS10F_TTCCGTGAGGTTGGAC	ECL-cells (HDC,MAOB)
RS10F_TTCGCTGCAATACCTG	ECL-cells (HDC,MAOB)
RS10F_TTGCATTAGAGCATCG	M-X-cells (GHRL)
RS11F_AAAGTGAGTTAGAGAT	ECL-cells (HDC,MAOB)
RS11F_AACAACCCAACCGATT	ECL-cells (HDC,MAOB)
RS11F_AAGACAATCAATGCAC	EC-cells (TPH1)
RS11F_AAGCATCAGACGCCAA	M-X-cells (GHRL)
RS11F_AAGGTAACATGCCATA	M-X-cells (GHRL)
RS11F_AATAGAGAGTAGATCA	M-X-cells (GHRL)
RS11F_AATAGAGCAATAGAGT	M-X-cells (GHRL)
RS11F_AATAGAGTCTAGTTCT	M-X-cells (GHRL)
RS11F_AATCGTGTCCACTGAA	M-X-cells (GHRL)
RS11F_ACAAGCTGTCCGTTTC	M-X-cells (GHRL)
RS11F_ACACTGAAGCTGTTAC	M-X-cells (GHRL)
RS11F_ACCCTCAGTTGGCCTG	EC-cells (TPH1)
RS11F_ACGATGTAGGGATCAC	M-X-cells (GHRL)
RS11F_ACGGTTATCCCGAACG	ECL-cells (HDC,MAOB)
RS11F_AGAAATGGTGCAGTGA	M-X-cells (GHRL)
RS11F_AGAAGTAAGGTGCATG	M-X-cells (GHRL)
RS11F_AGACCATCAGAACTAA	EC-cells (TPH1)
RS11F_AGACCATGTTCACGAT	ECL-cells (HDC,MAOB)
RS11F_AGACTCATCAGATTGC	M-X-cells (GHRL)
RS11F_AGAGAATTCACTGGGC	ECL-cells (HDC,MAOB)
RS11F_AGAGCAGGTACGGTTT	ECL-cells (HDC,MAOB)
RS11F_AGGACTTGTACCTAGT	M-X-cells (GHRL)
RS11F_AGGGCCTGTCCCGGTA	M-X-cells (GHRL)
RS11F_AGGTGTTTCCATTGCC	ECL-cells (HDC,MAOB)
RS11F_AGTACCATCGAAGCCC	ECL-cells (HDC,MAOB)
RS11F_ATACCGAAGCATCAGG	ECL-cells (HDC,MAOB)
RS11F_ATAGGCTCAAACTAAG	M-X-cells (GHRL)
RS11F_ATCGATGCATGCAGCC	ECL-cells (HDC,MAOB)
RS11F_ATGATCGCATGTGTCA	M-X-cells (GHRL)
RS11F_ATGCATGGTGCAGATG	ECL-cells (HDC,MAOB)
RS11F_ATGGATCAGGCAGGTT	M-X-cells (GHRL)
RS11F_ATTCTTGTCTCTAGGA	M-X-cells (GHRL)
RS11F_ATTGTTCGTTCGAAGG	M-X-cells (GHRL)
RS11F_CAAGAGGTCCCTGTTG	EC-cells (TPH1)
RS11F_CAAGGGACAATAGTCC	M-X-cells (GHRL)
RS11F_CAATACGTCCCAGCGA	M-X-cells (GHRL)
RS11F_CAATCGATCGTTATCT	M-X-cells (GHRL)
RS11F_CAATGACTCGACATAC	M-X-cells (GHRL)
RS11F_CACAGGCCATTGACAC	M-X-cells (GHRL)
RS11F_CACCAAATCCTTACCG	EC-cells (TPH1)
RS11F_CACGAATAGATCGACG	M-X-cells (GHRL)
RS11F_CACGTTCGTCTGTCAA	M-X-cells (GHRL)
RS11F_CACTGTCTCCCTCATG	M-X-cells (GHRL)
RS11F_CAGCACGAGCAAGGAA	M-X-cells (GHRL)
RS11F_CAGCCAGTCTATTCGT	ECL-cells (HDC,MAOB)
RS11F_CAGGCCAGTTAGAAGT	M-X-cells (GHRL)
RS11F_CAGTGCGGTCAGTCGC	ECL-cells (HDC,MAOB)
RS11F_CATTGAGGTTCTCCCA	M-X-cells (GHRL)
RS11F_CCACCATGTGTGTCGC	ECL-cells (HDC,MAOB)
RS11F_CCACTTGAGCGTGAAC	M-X-cells (GHRL)
RS11F_CCATCACAGTTAGTAG	M-X-cells (GHRL)
RS11F_CCCAACTGTTCGGTTA	M-X-cells (GHRL)
RS11F_CCCGGAAGTAGTCGGA	ECL-cells (HDC,MAOB)
RS11F_CCGGACACATGAAGGC	ECL-cells (HDC,MAOB)
RS11F_CCTAAGAGTAATGTGA	ECL-cells (HDC,MAOB)
RS11F_CCTATCGCAGGACTTT	ECL-cells (HDC,MAOB)
RS11F_CCTCTCCAGCAGGCTA	M-X-cells (GHRL)
RS11F_CGAGGAACAGCTTTCC	M-X-cells (GHRL)
RS11F_CGCAGGTCATCATCCC	M-X-cells (GHRL)
RS11F_CGCCATTCAGACCTAT	ECL-cells (HDC,MAOB)
RS11F_CGGTCAGGTCCACACG	M-X-cells (GHRL)
RS11F_CTAACTTCAAAGGGCT	ECL-cells (HDC,MAOB)
RS11F_CTAAGTGTCTGGGCGT	EC-cells (TPH1)
RS11F_CTACATTCAGGGACTA	ECL-cells (HDC,MAOB)
RS11F_CTACCCAGTAGCGCTC	ECL-cells (HDC,MAOB)
RS11F_CTATCTACAGAATCGG	M-X-cells (GHRL)
RS11F_CTCAACCCAATACGAA	M-X-cells (GHRL)
RS11F_CTCAACCTCGGCTGTG	M-X-cells (GHRL)
RS11F_CTCAATTTCTTCGACC	M-X-cells (GHRL)
RS11F_CTCAGAATCTACGCGG	M-X-cells (GHRL)
RS11F_CTCATCGAGCGGCTCT	ECL-cells (HDC,MAOB)
RS11F_CTCATGCGTAGATTAG	ECL-cells (HDC,MAOB)
RS11F_CTCCCAACACAGTCCG	ECL-cells (HDC,MAOB)
RS11F_CTCTCAGTCTTGAACG	M-X-cells (GHRL)
RS11F_CTCTGGTTCACTGGTA	M-X-cells (GHRL)
RS11F_CTGAGCGCACGCGCTA	M-X-cells (GHRL)
RS11F_CTGCATCTCGTCTAAG	M-X-cells (GHRL)
RS11F_CTGCCATGTGAGTGAC	M-X-cells (GHRL)
RS11F_CTGCGAGAGACTACGG	M-X-cells (GHRL)
RS11F_CTGCGAGTCTGCACCT	ECL-cells (HDC,MAOB)
RS11F_CTGGACGTCTATACTC	ECL-cells (HDC,MAOB)
RS11F_CTGTACCGTCGGAAAC	ECL-cells (HDC,MAOB)
RS11F_CTTACCGTCGAGGCAA	M-X-cells (GHRL)
RS11F_CTTTCAACAAGTCGTT	ECL-cells (HDC,MAOB)
RS11F_GAACGTTAGTCCCGGT	ECL-cells (HDC,MAOB)
RS11F_GAAGTAAAGTCATCCA	M-X-cells (GHRL)
RS11F_GAAGTAAGTCCGGTGT	M-X-cells (GHRL)
RS11F_GACAGCCTCGAGTTGT	M-X-cells (GHRL)
RS11F_GACATCACAAGGTCTT	M-X-cells (GHRL)
RS11F_GAGGGATGTTGTCAGT	M-X-cells (GHRL)
RS11F_GAGTGAGCAACAAGTA	ECL-cells (HDC,MAOB)
RS11F_GATCCCTAGGTTATAG	M-X-cells (GHRL)
RS11F_GATGAGGGTAGCCCTG	M-X-cells (GHRL)
RS11F_GATGATCCATATGGCT	M-X-cells (GHRL)
RS11F_GATGCTAGTTCTAAGC	M-X-cells (GHRL)
RS11F_GATGCTATCGTTTACT	ECL-cells (HDC,MAOB)
RS11F_GCAACATCATCGCTCT	EC-cells (TPH1)
RS11F_GCACATAAGAGGGTAA	M-X-cells (GHRL)
RS11F_GCACTAATCCGATGCG	M-X-cells (GHRL)
RS11F_GCATCTCTCTAGCCTC	ECL-cells (HDC,MAOB)
RS11F_GCATGATGTTGGGAAC	M-X-cells (GHRL)
RS11F_GCCAGCATCGGACTTA	ECL-cells (HDC,MAOB)
RS11F_GCCCGAATCTTACCGC	M-X-cells (GHRL)
RS11F_GCGAGAAGTCCGATCG	ECL-cells (HDC,MAOB)
RS11F_GCGAGAATCCATCTCG	ECL-cells (HDC,MAOB)
RS11F_GCGGAAACACTATCCC	ECL-cells (HDC,MAOB)
RS11F_GCGGATCCATCATCTT	M-X-cells (GHRL)
RS11F_GCGTTTCTCTACCCAC	M-X-cells (GHRL)
RS11F_GGAATCTAGAGCTTTC	ECL-cells (HDC,MAOB)
RS11F_GGAGGTAGTTAGTCGT	ECL-cells (HDC,MAOB)
RS11F_GGATGTTAGACTGTTC	M-X-cells (GHRL)
RS11F_GGCAGTCTCTCTATAC	M-X-cells (GHRL)
RS11F_GGGACCTGTTGAATCC	ECL-cells (HDC,MAOB)
RS11F_GGGATCCCAAGTGCAG	ECL-cells (HDC,MAOB)
RS11F_GGGATCCTCGCACGAC	M-X-cells (GHRL)
RS11F_GGTAACTAGCTCTATG	M-X-cells (GHRL)
RS11F_GGTAACTGTCTAGATC	M-X-cells (GHRL)
RS11F_GTAACACAGGCCACTC	ECL-cells (HDC,MAOB)
RS11F_GTAACACCACTTGTCC	M-X-cells (GHRL)
RS11F_GTAATGCCACCAAAGG	EC-cells (TPH1)
RS11F_GTAGATCGTCCTCAGG	ECL-cells (HDC,MAOB)
RS11F_GTAGGAGTCTTGTTAC	M-X-cells (GHRL)
RS11F_GTAGGTTAGTCCCTAA	EC-cells (TPH1)
RS11F_GTAGTACTCCAAGGGA	M-X-cells (GHRL)
RS11F_GTATTTCTCCCGAGTG	ECL-cells (HDC,MAOB)
RS11F_GTCACGGTCGCTCTAC	M-X-cells (GHRL)
RS11F_GTCACTCTCAAGAGGC	M-X-cells (GHRL)
RS11F_GTCAGCGTCGTCGACG	M-X-cells (GHRL)
RS11F_GTCATTTTCATTGCGA	M-X-cells (GHRL)
RS11F_GTCATTTTCTGGGCCA	M-X-cells (GHRL)
RS11F_GTCCTCAAGGAATCGC	M-X-cells (GHRL)
RS11F_GTCCTCACAGTAGTTC	ECL-cells (HDC,MAOB)
RS11F_GTCTGTCGTACCTATG	ECL-cells (HDC,MAOB)
RS11F_GTGAGCCGTGTTCCTC	M-X-cells (GHRL)
RS11F_GTGAGTTCATCTCATT	ECL-cells (HDC,MAOB)
RS11F_GTGCTGGCATGACGTT	EC-cells (TPH1)
RS11F_GTGTTCCAGTGTAGAT	M-X-cells (GHRL)
RS11F_GTTACCCAGTGTACCT	M-X-cells (GHRL)
RS11F_GTTAGTGAGCGATGGT	EC-cells (TPH1)
RS11F_GTTAGTGAGGCACGAT	M-X-cells (GHRL)
RS11F_TAAGCACAGGGACACT	M-X-cells (GHRL)
RS11F_TAATTCCAGGCGACAT	M-X-cells (GHRL)
RS11F_TACACCCCAGCTACAT	M-X-cells (GHRL)
RS11F_TACAGGTGTAGACACG	ECL-cells (HDC,MAOB)
RS11F_TACCCACCATTGCCTC	M-X-cells (GHRL)
RS11F_TACCGAAGTAGAATAC	ECL-cells (HDC,MAOB)
RS11F_TACCTGCTCTATCACT	M-X-cells (GHRL)
RS11F_TACGCTCCATCGCCTT	M-X-cells (GHRL)
RS11F_TACGCTCGTGCACATT	EC-cells (TPH1)
RS11F_TACGGTAGTCCAGCGT	ECL-cells (HDC,MAOB)
RS11F_TACTGCCCAAACACCT	EC-cells (TPH1)
RS11F_TACTTACCACATAACC	ECL-cells (HDC,MAOB)
RS11F_TACTTCAAGAGTCAAT	M-X-cells (GHRL)
RS11F_TAGATCGAGCTGACCC	EC-cells (TPH1)
RS11F_TATCAGGTCATCGACA	M-X-cells (GHRL)
RS11F_TATCGCCGTCAAGCCC	M-X-cells (GHRL)
RS11F_TATTGGGGTATGGAAT	M-X-cells (GHRL)
RS11F_TCAATCTGTGAGATAT	M-X-cells (GHRL)
RS11F_TCACACCTCGCCGAGT	M-X-cells (GHRL)
RS11F_TCAGCAAAGTATCTGC	ECL-cells (HDC,MAOB)
RS11F_TCAGTCCTCGTTTACT	M-X-cells (GHRL)
RS11F_TCATACTTCCATTGGA	ECL-cells (HDC,MAOB)
RS11F_TCATACTTCTATGCCC	M-X-cells (GHRL)
RS11F_TCCGAAACAGCAATTC	M-X-cells (GHRL)
RS11F_TCCGGGATCAGTGCGC	ECL-cells (HDC,MAOB)
RS11F_TCCTTTCGTCGGATTT	M-X-cells (GHRL)
RS11F_TCGACGGGTATGTCTG	M-X-cells (GHRL)
RS11F_TCGCAGGGTCGTATTG	M-X-cells (GHRL)
RS11F_TCGCAGGTCAACCTCC	ECL-cells (HDC,MAOB)
RS11F_TCGGGACGTCAAATCC	ECL-cells (HDC,MAOB)
RS11F_TCGGGCAGTCGACGCT	M-X-cells (GHRL)
RS11F_TCTCAGCTCCGAGATT	M-X-cells (GHRL)
RS11F_TCTGTCGAGGTCACAG	M-X-cells (GHRL)
RS11F_TCTTGCGGTCGGAAAC	M-X-cells (GHRL)
RS11F_TGACAGTCAGGCGTTC	ECL-cells (HDC,MAOB)
RS11F_TGATCAGGTGTGTTTG	M-X-cells (GHRL)
RS11F_TGATGGTAGTATCTGC	M-X-cells (GHRL)
RS11F_TGATTCTAGCGTGTCC	M-X-cells (GHRL)
RS11F_TGATTCTTCAAACGAA	M-X-cells (GHRL)
RS11F_TGCAGTAAGAAGTGTT	EC-cells (TPH1)
RS11F_TGCATGAGTGATTCAC	ECL-cells (HDC,MAOB)
RS11F_TGCGATAGTCCCGTGA	ECL-cells (HDC,MAOB)
RS11F_TGCGATATCCACAGGC	ECL-cells (HDC,MAOB)
RS11F_TGGATCAAGTTCCGTA	ECL-cells (HDC,MAOB)
RS11F_TGGATGTTCCGAGAAG	M-X-cells (GHRL)
RS11F_TGGGCTGAGTAGATCA	M-X-cells (GHRL)
RS11F_TGGTACACACACACTA	M-X-cells (GHRL)
RS11F_TGTAAGCTCTAGGCAT	M-X-cells (GHRL)
RS11F_TGTACAGGTACTGCGC	ECL-cells (HDC,MAOB)
RS11F_TGTCCCAAGGAAACGA	M-X-cells (GHRL)
RS11F_TGTGGCGAGTAAATGC	ECL-cells (HDC,MAOB)
RS11F_TGTTTGTTCTTGATTC	M-X-cells (GHRL)
RS11F_TTACGTTCAATGTCTG	ECL-cells (HDC,MAOB)
RS11F_TTACTGTCACAGTGTT	M-X-cells (GHRL)
RS11F_TTACTGTGTCCGAAGA	M-X-cells (GHRL)
RS11F_TTAGTCTTCTGAGCAT	M-X-cells (GHRL)
RS11F_TTCAATCGTGAGTCAG	M-X-cells (GHRL)
RS11F_TTCCAATAGTTTAGGA	M-X-cells (GHRL)
RS11F_TTCCACGAGTCGCGAA	ECL-cells (HDC,MAOB)
RS11F_TTCGATTGTGGTATGG	M-X-cells (GHRL)
RS11F_TTCGCTGTCTAGAGCT	M-X-cells (GHRL)
RS11F_TTCGGTCGTCAGGAGT	M-X-cells (GHRL)
RS11F_TTCTTCCTCGGACGTC	M-X-cells (GHRL)
RS11F_TTGCCTGAGATACGAT	M-X-cells (GHRL)
RS11F_TTGCTGCCAAGACCGA	ECL-cells (HDC,MAOB)
RS11F_TTGGATGCAGTCTGGC	ECL-cells (HDC,MAOB)
RS11F_TTGTGTTCAGCGGTCT	M-X-cells (GHRL)
RS11F_TTTACCAAGAGGGTGG	ECL-cells (HDC,MAOB)
RS11F_TTTAGTCTCTTTCGAT	M-X-cells (GHRL)
RS11F_TTTGATCCATCTAGAC	ECL-cells (HDC,MAOB)
RS11F_TTTGGAGAGCATTTCG	ECL-cells (HDC,MAOB)
RS11F_TTTGTTGGTACTCAAC	M-X-cells (GHRL)
